###################
#1.......#.......1#
#.##.###.#.###.##.#
#........U........#
#.##.#.#####.#.##.#
#U...#...#...#...U#
####.###.#.###.####
   #.#.......#.#   
####.#.## ##.#.####
.......##1##.......
####.#.#####.#.####
   #.#.......#.#   
####.#.#####.#.####
#........#........#
#.##.###.#.###.##.#
#U.#.....O.....#.U#
##.#.#.#####.#.#.##
#....#...#...#....#
#.######.#.######.#
#........U........#
###################